  #############################
#   #         #               #
### # ####### # #   # ####### #
#   # #     # # # # #     #####
# ### # ### # # # # ####### # #
# #   # # # # # # #       # # #
# # ### # # # # # #########   #
# #   # # # # # #           # #
# ### # # # # # ############# #
#   # # # # #    #            #
### # # # ######### ###########
#   # # #         #     #     #
# ### # ######### # ### # ### #
#     #         #         #   #
##### ####### # ############# #
#         #   #     #     *   #
###############################
